EA ./img/east.png
NO ./img/north.png
WE ./img/west.png
SO ./img/south.png

F 220,100,0
C 225,30,0



                           111111111
                           100000001
                           100000001
                           100000001
111111111          11111   100000001
100000001111111111110001   100000001
100010000000000000000W01   100000001
100010001111111111110001   111101111
100000001          11111      101
111111101                     101
      101          11111      101
      101          10001111111101             
      101          10000000000001
    111011111111   10001111111101               111
    100000000001   11111      101               101
    100001100001              101               111
    100001100001              101  
    100000000001 11111111111 11011
    111111111011110000000001 10001
            1000000001110001110001
            1111110001 10000000001
                 11111 11111111111
                 