EA textures/wall4.xpm
NO textures/wall2.xpm
WE textures/wall.xpm
SO textures/wall3.xpm

F 1, 183, 255
C 0,  100  , 20

                           1111111111
                           1000000001
                           10000S0001
                           1000000001
111111111          11111   1000000001
100000001111111111110001   1000000001
100010000000000000000001   1000000001
100010001111111111110001   1111001111
100000001          11111      1001
111111101                     1001
      101          11111      1001
      101          100011111111001
      101          100000000000001
    111011111111   100011111111001
    100000000001   11111      1001
    100001100001              1001
    100001100001              1001
    100000000001 11111111111 110011
    111111111011110000000001 100001
            10000000011100011100001
            1111110001 100000000001
                 11111 111111111111










